000000000100
013000000000
000000010000
100000000000
000000000000
000020000000
000000000010
000000100000
000000000000
000000000001
000010000000
000000000000