100000001010
100000000100
000100000100
000000000100
001002000001
000000000000
030001101010