00000001000000000
01000000000010000
00000000000000000
00000000003000000
10200000100000000
00000000000000001
00000000000100000
01000000000000000
00000001000000000
00100000000000000
10000000010000000
00000010000000010
