00000001000
00300000000
02000100000
00000000100
00001000000
00000000000