0000000000001
0100000000000
0000000000010
0000000001000
0000000000000
0000300000000
0000000000102
0010000000000
1000000000000
0000000000001