0000000000100
0100000000000
0000030100000
0001000000001
1000000000000
0000000000010
0000100000000
0000000200000
0000000100000