001000000000
000000000010
000000130000
000000001000
002001000000
000000000100
