000000000000000
002000010000100
001000000000000
000010000100000
000000000010000
000000000031000
000100000100000
000000100000000
000000000100000
