001000110000100
010000000010000
000100130000010
100000001000100
102001000000000
010010000100010
