0100000002
0100010000
0010000100
0300100000
0100000001
1000001001