0100000000100
0000031000000
0100000000010
0000000100000
1000000000001
0000000000000
2000000010000
0001000000000
0000000000000
0001000000010
0000001100000
0010001000100