0100000000002
0000000000100
1000000000000
0000000001000
0011000000000
0000000000010
0010000000000
0000000010000
0300100000001