0010000010
1000003000
0100001000
0100000000
0000000000
0000000100
0100010000
0000001000
0200100010
0000010000