001000000000
100000010000
000000000100
000100000000
000000000010
010000000000
000000001000
000000000000
100000000000
000030010000
000010000000
100020000001