000010000000
000000000001
012000000000
000000000010
000000010000
100100000000
000001000100
100000001300
001000000000
000000000001
010000000010
000010000000