0000000000001100
1000000000000000
0000010000000000
0000000000000100
0000100200000000
0000000000010000
0100300100000000
0001000000000000
0010000000001000
0000000000000001
1000010000100000
