1000000000010
0000000100000
0100000000000
0001000000000
0000000300000
0000000001000
0000000000000
0010000000100
0000001000000
2000000000001