0000100000
0010000030
0000000010
0000000000
0000000000
0000000000
0001000010
0020000100
0000100000
0000000000