0000000000
0200000010
0100000000
0000101000
0001030000
1000000001
0000000100
0010000000
0000000010
0100000000