0100000000100
0000010000000
0010000000000
1000200000010
0000000001000
0100100000000
0001000000100
0001000000001
0000010000000
0000000001000
1000000000010
0010000000030
0000100000000
0100000000100