01000000000000
00000000000010
00000010000000
00100000000001
10000000000000
00010020001000
00000000000000
00000000000001
10000000000000
00000010000000
01000001000000
00000001000100
00000000000010
00100000000300