01000000000010
00010010000000
00110000000100
00001000000001
00000000001000
30000000000000
00000000010000
00000001000000
00000000000100
00000100000000
00010000000000
10000020000001
01000000000001
00003010000000